··············
·#+··········h
·+·X··X·H-----
······X··-···H
······E··-····
·XXE-------EXX
····-···H·····