····-·······H·
·XXE----·XXE--
····H··-····-·
·+·····-·H··-·
·#·XXE-------·
·+····-··H··-·
···H··-·····h·
XXE----·······