·····XXE---EXX···#+rR
·#+······-·····+·+···
····X·XXE------#·····
·++·X····-····H··+··+
····E·H··-·······#··#
·XXE-------EXX·X·#+·+
····-···H······X·+··+
····-········H·E·····
·XXE----·XXE----EXX··
····H··-····-··E····+
·+·····-·H··-··X·+··+
·#·XXE-------··X·#+·#
·+····-·····-····+···
······-·····H··#···F·
XXE----EXX·····#·++++