·····················
·····················
··············hR·····
·····················
····-······X·········
····-··+···X·········
····-··#+··E·········
···-----------·······
····+····-··H········
·········-···········
·········-···········
·········-H··········
·········-···········
·····················
·····················