····----------·····rR
·++·-··H·X··h··#+····
·#··-····X·····+·····
····-····E··········+
·H----------·····X···
·······-···--EXX·X···
+··XXE--···-··-··E··+
+······-XXE-··-··-··+
#···#··H···-··-··-··+
···X·····----------··
H··X·····-··-··E··-··
-··E··X·H-··-·#X·+E·+
-··-··X··-··h··X··X·+
-··-··E··-····+··+X··
----------···········