····XXXE---EXX···#+rR
#·+·X····-···-·+·+···
+·#·XXXE-------#·····
#·+·E····-····H··+··+
····-·H··-·······#··#
·XXE--------EXXX·#+·+
····-···H··-···X·+··+
····-······-·H·E·····
·XXE----XXE-----EXX··
····H·-·····-··E····+
·+····-···H·-··X·+··+
+#·XXE---------X·#+·#
·+····-···E·-····+···
······-···X·H··#·····
XXE----EXXX····#+++F+