·················#·rR
·#+··········h·#·····
·+·X··X·H-------·····
······X··-···H·······
······E··-·······+··#
·XXE-------EXX·X·#+·+
····-···H······X·+··+
····-·······H··E·····
·XXE----·XXE----EXX··
····H··-····-··E····+
·+·····-·H··-··X·+··+
·#·XXE-------··X·#+·#
·+····-··H··-····+···
···H··-·····h··#·····
XXE----········#···X·