·····ZXE---EXZ···#+rR
#·+·Z····-···-·+·+···
+·#·XZXE-------#·····
#·+·E····-····H··+··+
····-·H··-·······#··#
·ZXE--------EXZZ·#+·+
····-···H··-···X·+··+
····-······-·H·E·····
·ZXE----ZXE-----EXZ··
····H·-·····-··E····+
·+····-···H·-··X·+··+
+#·ZXE---------Z·#+·#
·+····-···E·-····+···
······-···X·H··#·····
ZXE----EXZZ····#+++F+